0000000000000000000000000000000000000000000000000000000000000000000000000000000000000000
0000000000000000000000000000000000000000000000000000000000000000000000000000000000000000
0001111111111111111111111111111111111111111111111111111111111111111111111111111000000000
0001001000000000001000000000000001001000001000000001000000000000000000001000001000000000
0001001000000000001000000000000001001000001000000001000000000000000000001000001001000100
0001001001001111111001111111001001001001001001001111001111001111111111001001001001000100
0001001001000000000001000000001001001001000001001000000001000000001000000001001001000100
0001001001000000000001000000001001001001000001001000000001000000001000000001001001000100
0001001111111111111111001111111001001001111111001001111111111111001111111111001001000100
0001001000000000000000001000000001000000000001001001001000000001000001000001001001111100
0001001000000000000000001000000001000000000001001001001000000001000001000001001000000000
0001001001111111111111111001111111111111111001001001001001111001001001001001111000000000
0001000001001000000000001001000000000001000001000000001001000001001000001000001001111100
0001000001001000000000001001000000000001000001000000001001000001001000001000001001000000
0001111111001001111001001001001111111001111111111111001001001111111111111111001001000000
0001000000001000001001001000001000000001000000000000001001000000000000001000001001111100
0001000000001000001001001000001000000001000000000000001001000000000000001000001001000000
0001001001111111001001111111111001111111111111111111001001111111111111001001001001000000
0001001000000000001000001000000001001000000001000000001000000001000000000001001001111100
0001001000000000001000001000000001001000000001000000001000000001000000000001001000000000
0001001111111111111111001001111111001001111001001111111001111001111111111111001000000000
0001001000001000000001000001000000001001221001001000001000001000000001000001001001111100
0001001000001000000001000001000000001001221001001000001000001000000001000001001000010000
0001001001001001111001111111001111111001001001001001001111111111111001001111001000010000
0001001001000001000001000000001000001000001001001001001000000000000001001000001000010000
0001001001000001000001000000001000001000001001001001001000000000000001001000001000010000
0001001111111111001001001111111001001111111001001001001001111111111111001001111000010000
0001000000000000001001001000000001001000001000001001000001000000000000001000001000000000
0001000000000000001001001000000001001000001000001001000001000000000000001000001000000000
0001111111111111001001001001111111001001001001111001111111111111111001111111001001000100
0001000000000000001000001001000001000001001001000000000001000000001000000001001001100100
0001000000000000001000001001000001000001001001000000000001000000001000000001001001010100
0001001001111111001111111001001111111111001111111111111001001111001111111001001001001100
0001001001000001000000001001000000000000000000000000001001001001000001000001001001000100
0001001001000001000000001001000000000000000000000000001001001001000001000001001000000000
0001001111001001111001111001001111111111001111111111001001001001111001001111001000000000
0001000001001001000001000001001000001000001000000001000000000001001001000000001001111100
0001000001001001000001000001001000001000001000000001000000000001001001000000001001000100
0001001001001001111001001111001001001001111001111001001111111001001001001111111001000100
0001001001001000001001001001000001001001001001001000001000001000001001000001001001000100
0001001001001000001001001001000001001001001001001000001000001000001001000001001001111100
0001001001001111001111001001001111111001001001001111111001001111111001111001001000000000
0001001000001001001000001000001000000001000001000000000001000001000001001001001000000000
0001001000001001001000001000001000000001000001000000000001000001000001001001001000010000
0001001111111001001001111111111001111111001111001111111111111001001111001001001000010000
0001000000000001000000000000000001000000000000001000000000000000001000000000001000010000
0001000000000001000000000000000001000000000000001000000000000000001000000000001000010000
0001111111111111111111111111111111111111111111111111111111111111111111111111111000010000
0000000000000000000000000000000000000000000000000000000000000000000000000000000000000000
0000000000000000000000000000000000000000000000000000000000000000000000000000000000000000