000000000000000000000000000000000000000000000000000000000000000000000000000000000000000
000000000000000000000000000000000000000000000000000000000000000000000000000000000000000
000111111111111111111111111111111111111111111111111111111111111111111111111111100000000
000100100000000000100000000000000100100000100000000100000000000000000000100000100000000
000100100000000000100000000000000100100000100000000100000000000000000000100000100100010
000100100100111111100111111100100100100100100100111100111100111111111100100100100100010
000100100100000000000100000000100100100100000100100000000100000000100000000100100100010
000100100100000000000100000000100100100100000100100000000100000000100000000100100100010
000100111111111111111100111111100100100111111100100111111111111100111111111100100100010
000100100000000000000000100000000100000000000100100100100000000100000100000100100111110
000100100000000000000000100000000100000000000100100100100000000100000100000100100000000
000100100111111111111111100111111111111111100100100100100111100100100100100111100000000
000100000100100000000000100100000000000100000100000000100100000100100000100000100111110
000100000100100000000000100100000000000100000100000000100100000100100000100000100100000
000111111100100111100100100100111111100111111111111100100100111111111111111100100100000
000100000000100000100100100000100000000100000000000000100100000000000000100000100111110
000100000000100000100100100000100000000100000000000000100100000000000000100000100100000
000100100111111100100111111111100111111111111111111100100111111111111100100100100100000
000100100000000000100000100000000100100000000100000000100000000100000000000100100111110
000100100000000000100000100000000100100000000100000000100000000100000000000100100000000
000100111111111111111100100111111100100111100100111111100111100111111111111100100000000
000100100000100000000100000100000000100122100100100000100000100000000100000100100111110
000100100000100000000100000100000000100122100100100000100000100000000100000100100001000
000100100100100111100111111100111111100100100100100100111111111111100100111100100001000
000100100100000100000100000000100000100000100100100100100000000000000100100000100001000
000100100100000100000100000000100000100000100100100100100000000000000100100000100001000
000100111111111100100100111111100100111111100100100100100111111111111100100111100001000
000100000000000000100100100000000100100000100000100100000100000000000000100000100000000
000100000000000000100100100000000100100000100000100100000100000000000000100000100000000
000111111111111100100100100111111100100100100111100111111111111111100111111100100100010
000100000000000000100000100100000100000100100100000000000100000000100000000100100110010
000100000000000000100000100100000100000100100100000000000100000000100000000100100101010
000100100111111100111111100100111111111100111111111111100100111100111111100100100100110
000100100100000100000000100100000000000000000000000000100100100100000100000100100100010
000100100100000100000000100100000000000000000000000000100100100100000100000100100000000
000100111100100111100111100100111111111100111111111100100100100111100100111100100000000
000100000100100100000100000100100000100000100000000100000000000100100100000000100111110
000100000100100100000100000100100000100000100000000100000000000100100100000000100100010
000100100100100111100100111100100100100111100111100100111111100100100100111111100100010
000100100100100000100100100100000100100100100100100000100000100000100100000100100100010
000100100100100000100100100100000100100100100100100000100000100000100100000100100111110
000100100100111100111100100100111111100100100100111111100100111111100111100100100000000
000100100000100100100000100000100000000100000100000000000100000100000100100100100000000
000100100000100100100000100000100000000100000100000000000100000100000100100100100001000
000100111111100100100111111111100111111100111100111111111111100100111100100100100001000
000100000000000100000000000000000100000000000000100000000000000000100000000000100001000
000100000000000100000000000000000100000000000000100000000000000000100000000000100001000
000111111111111111111111111111111111111111111111111111111111111111111111111111100001000
000000000000000000000000000000000000000000000000000000000000000000000000000000000000000